R 1920 1080
NO ./texture/wall_1.xpm
SO ./texture/wall_2.xpm
WE ./texture/wall_3.xpm
EA ./texture/wall_4.xpm
S ./texture/sprite_1.xpm
F 220,100,0
C 100,80,25

        1111111111111111111111111
        1000000000110000000000001
        1011000001110000000000001
        1001000000000000000000001
111111111011000001110000000000001
100000000011000001110111111111111
11110111111111011100000010001
11110111111111011101010010001
11000000110101011100000000001
10000000000000001100000000001
10000000000000000001010010001
1100000101010100000101111000111             111
1111011101110101  01111010001               1 1
11111111 1111111  11111111111               121
1111111101111111  11111111111111111111111111121
10000000000000000000000000000000000000000000001
10000000000000000000000000000000000000000000001
1                                             1
11000111111111111111111111111111111111111111111
10 0001
1100011
1    111111111111111111111111111111111111111111
1000S000000000000001000000000000000000000000001
10000000000000000000000000000000200000000000001
10000000000000000000000000000000000000000000001
10000000000000000000000000000000200000000000001
10002000000000000000000000000000000000000000001
10000000000000000000000200000000000000000000001
10000000000000000002000000000000000000000000001
10000000000000000000000000000000000000000000001
10000000000000000000000000000000000000000000001
10000000000000000000000000000000000000000000001
10000000000000000000000000000000000000000000001
10000000000000000000000000000000000000000000001
10000000000000000000000000000000000000000000001
10000000000000000000000000000000000000000000001
11111111111111111111111111111111111111111111111
